%%%%%%%%%%%%
%P.........%
%..........%
%..........%
%..........%
%..........%
%%%%%%%%%%%%
