%%%%%
%. .%
% P %
%. .%
%%%%%  
