%%%%%%%%%%%%%%%%%%%%%%%%%%%%%%%%%%%%%%%%%%
%                                        %
%       %   G %%%%%%%%          G        %
%      %                                 %
% %%%%%                 P                %
%                                        %
%      %%%%%%%%%%%%%%%%%%%%%%            %
%               ..............           %
%                                        %
%%%%%%%%%%%%%%%%%%%%%%%%%%%%%%%%%%%%%%%%%%
